"aA" = (/obj/structure/table/rolling,/obj/item/petri_dish/random,/obj/structure/window/reinforced/spawner,/turf/open/floor/plastic,/area/ruin/bughabitat)
"br" = (/obj/effect/turf_decal/siding/wideplating/dark/corner{dir = 8},/obj/effect/turf_decal/tile/dark/anticorner{dir = 4},/turf/open/floor/iron,/area/ruin/bughabitat)
"bI" = (/obj/effect/turf_decal/siding/wideplating/light{color = "#236F26"; dir = 8},/turf/open/floor/plastic,/area/ruin/bughabitat)
"bU" = (/obj/structure/window/reinforced/tinted/fulltile,/obj/structure/grille,/turf/open/floor/iron,/area/ruin/bughabitat)
"cC" = (/obj/structure/table,/obj/machinery/light_switch/directional/south,/obj/machinery/cell_charger,/obj/effect/turf_decal/siding/wideplating/light{color = "#236F26"},/turf/open/floor/plastic,/area/ruin/bughabitat)
"cD" = (/obj/machinery/hydroponics/constructable,/turf/open/floor/plastic,/area/ruin/bughabitat)
"cL" = (/obj/structure/table,/obj/structure/windoor_assembly{dir = 4},/turf/open/floor/plastic,/area/ruin/bughabitat)
"dl" = (/obj/structure/table,/obj/item/construction/plumbing/research,/turf/open/floor/plastic,/area/ruin/bughabitat)
"eu" = (/obj/machinery/light/warm/directional/west,/obj/structure/tank_holder/oxygen,/turf/open/floor/plastic,/area/ruin/bughabitat)
"eD" = (/obj/effect/decal/remains/human,/turf/open/floor/carpet/neon/simple/lime,/area/ruin/bughabitat)
"eP" = (/obj/structure/toilet{dir = 8},/obj/item/plunger,/mob/living/simple_animal/mouse,/obj/machinery/light/small/blacklight/directional/south,/turf/open/floor/plastic,/area/ruin/bughabitat)
"fv" = (/turf/open/floor/iron,/area/ruin/bughabitat)
"fP" = (/obj/item/reagent_containers/syringe,/turf/open/floor/iron,/area/ruin/bughabitat)
"ge" = (/obj/machinery/door/airlock/public,/turf/open/floor/plastic,/area/ruin/bughabitat)
"gk" = (/obj/effect/decal/cleanable/blood/drip,/turf/open/floor/iron,/area/ruin/bughabitat)
"gP" = (/obj/machinery/door/window/northright,/obj/effect/turf_decal/siding/wideplating/light{color = "#236F26"; dir = 1},/turf/open/floor/plastic,/area/ruin/bughabitat)
"hk" = (/obj/structure/cable,/obj/structure/window/reinforced/spawner/east,/obj/effect/turf_decal/siding/wideplating/light{color = "#236F26"; dir = 6},/obj/machinery/portable_atmospherics/scrubber,/turf/open/floor/plastic,/area/ruin/bughabitat)
"iA" = (/obj/structure/chair/pew/right{dir = 8},/obj/item/bedsheet{pixel_y = 13},/obj/machinery/light_switch/directional/east,/turf/open/floor/plastic,/area/ruin/bughabitat)
"iL" = (/mob/living/simple_animal/ant,/turf/open/floor/grass,/area/ruin/bughabitat)
"jL" = (/obj/structure/window/reinforced/spawner/east,/obj/item/wallframe/camera,/obj/item/stack/cable_coil/cut,/turf/open/floor/grass,/area/ruin/bughabitat)
"lk" = (/obj/machinery/light_switch/directional/south,/turf/open/floor/plastic,/area/ruin/bughabitat)
"nD" = (/obj/machinery/light/warm/directional/east,/obj/structure/closet,/obj/item/food/cheese,/obj/item/stack/rods/ten,/turf/open/floor/plastic,/area/ruin/bughabitat)
"oE" = (/obj/structure/window/reinforced/spawner/east,/turf/open/floor/grass/snow,/area/ruin/bughabitat)
"oL" = (/obj/structure/sink{dir = 4},/obj/effect/turf_decal/siding/wideplating/light{color = "#236F26"; dir = 8},/turf/open/floor/plastic,/area/ruin/bughabitat)
"pD" = (/turf/closed/wall,/area/ruin/bughabitat)
"qM" = (/obj/machinery/light/warm/directional/west,/obj/machinery/door/window/northright,/obj/effect/turf_decal/siding/wideplating/light{color = "#236F26"; dir = 9},/turf/open/floor/plastic,/area/ruin/bughabitat)
"rj" = (/turf/open/floor/grass,/area/ruin/bughabitat)
"rY" = (/obj/structure/window/reinforced/spawner/north,/obj/machinery/biogenerator,/obj/structure/window/reinforced/spawner/east,/obj/effect/turf_decal/siding/wideplating/light{color = "#236F26"; dir = 5},/turf/open/floor/plastic,/area/ruin/bughabitat)
"sC" = (/obj/machinery/plumbing/growing_vat,/turf/open/floor/iron,/area/ruin/bughabitat)
"tg" = (/obj/item/coin/silver,/obj/item/reagent_containers/syringe,/turf/open/floor/plastic,/area/ruin/bughabitat)
"vs" = (/obj/structure/window/reinforced/spawner/east,/obj/item/shovel,/turf/open/floor/grass/snow,/area/ruin/bughabitat)
"vw" = (/obj/machinery/space_heater,/turf/open/floor/plastic,/area/ruin/bughabitat)
"wO" = (/obj/structure/window/reinforced/spawner/east,/turf/open/floor/grass/snow/basalt/safe,/area/ruin/bughabitat)
"xv" = (/obj/machinery/space_heater,/turf/open/floor/carpet/neon/simple/lime,/area/ruin/bughabitat)
"zG" = (/turf/open/floor/plating/dirt/jungle,/area/mine/unexplored/planetgeneration/nogen)
"At" = (/obj/structure/window/reinforced/spawner/east,/mob/living/basic/cockroach,/turf/open/floor/grass/snow/basalt/safe,/area/ruin/bughabitat)
"AP" = (/obj/item/reagent_containers/syringe/syriniver,/obj/effect/turf_decal/siding/wideplating/dark/corner,/obj/effect/turf_decal/tile/dark/anticorner,/turf/open/floor/iron,/area/ruin/bughabitat)
"AR" = (/obj/machinery/door/airlock/public,/turf/open/floor/carpet/neon/simple/lime,/area/ruin/bughabitat)
"Bt" = (/obj/effect/turf_decal/stripes/white/line{color = "#236F26"; dir = 4},/turf/open/floor/plastic,/area/ruin/bughabitat)
"CG" = (/obj/structure/window/reinforced/spawner/east,/obj/effect/spawner/random/food_or_drink/snack,/turf/open/floor/grass,/area/ruin/bughabitat)
"DE" = (/obj/machinery/light/warm/directional/east,/obj/effect/decal/cleanable/blood/footprints,/turf/open/floor/iron,/area/ruin/bughabitat)
"Eb" = (/obj/effect/decal/remains/human,/obj/item/clothing/suit/toggle/labcoat,/obj/machinery/power/apc/auto_name/directional/west,/obj/structure/cable,/obj/structure/window/reinforced/spawner/north,/turf/open/floor/plastic,/area/ruin/bughabitat)
"EA" = (/mob/living/basic/cockroach,/obj/item/seeds/soya,/turf/open/floor/grass/snow/basalt/safe,/area/ruin/bughabitat)
"EL" = (/turf/open/floor/grass/snow,/area/ruin/bughabitat)
"FP" = (/turf/open/floor/carpet/neon/simple/lime,/area/ruin/bughabitat)
"Gg" = (/obj/effect/spawner/structure/window/hollow/directional{dir = 4},/turf/open/floor/plastic,/area/ruin/bughabitat)
"Hw" = (/obj/effect/turf_decal/siding/wideplating/dark/corner{dir = 1},/obj/effect/turf_decal/tile/dark/anticorner{dir = 1},/turf/open/floor/iron,/area/ruin/bughabitat)
"JE" = (/obj/machinery/light/warm/directional/east,/obj/item/clothing/suit/toggle/labcoat/mad,/turf/open/floor/carpet/neon/simple/lime,/area/ruin/bughabitat)
"Lo" = (/obj/effect/spawner/random/food_or_drink/snack,/mob/living/basic/cockroach,/turf/open/floor/grass/snow/basalt/safe,/area/ruin/bughabitat)
"LQ" = (/obj/effect/spawner/random/vending/snackvend,/turf/open/floor/plastic,/area/ruin/bughabitat)
"Ml" = (/turf/open/floor/plastic,/area/ruin/bughabitat)
"Na" = (/obj/effect/turf_decal/siding/wideplating/light{color = "#236F26"; dir = 10},/turf/open/floor/plastic,/area/ruin/bughabitat)
"NM" = (/mob/living/simple_animal/butterfly,/obj/effect/turf_decal/siding/wideplating/light{color = "#236F26"},/turf/open/floor/plastic,/area/ruin/bughabitat)
"QU" = (/obj/item/pen/fountain,/turf/open/floor/iron,/area/ruin/bughabitat)
"SC" = (/obj/item/coin/silver,/turf/open/floor/iron,/area/ruin/bughabitat)
"SW" = (/obj/item/trash/shrimp_chips,/turf/open/floor/plastic,/area/ruin/bughabitat)
"Ta" = (/obj/effect/decal/remains/human,/obj/item/clipboard,/turf/open/floor/iron,/area/ruin/bughabitat)
"Tr" = (/obj/structure/table,/obj/item/stack/ducts/fifty{amount = 23},/mob/living/simple_animal/butterfly,/turf/open/floor/plastic,/area/ruin/bughabitat)
"Uv" = (/obj/machinery/door/window/eastleft,/obj/effect/turf_decal/siding/wideplating/light{color = "#236F26"; dir = 4},/turf/open/floor/iron,/area/ruin/bughabitat)
"Uw" = (/obj/structure/extinguisher_cabinet/directional/east,/turf/open/floor/iron,/area/ruin/bughabitat)
"Uy" = (/obj/structure/table,/obj/machinery/microwave,/obj/effect/turf_decal/siding/wideplating/light{color = "#236F26"},/turf/open/floor/plastic,/area/ruin/bughabitat)
"UM" = (/obj/effect/turf_decal/siding/wideplating/dark/corner{dir = 4},/obj/effect/turf_decal/tile/dark/anticorner{dir = 4},/turf/open/floor/iron,/area/ruin/bughabitat)
"VE" = (/obj/machinery/door/airlock/grunge,/turf/open/floor/plastic,/area/ruin/bughabitat)
"VX" = (/turf/template_noop,/area/template_noop)
"Wo" = (/obj/machinery/door/airlock/public{dir = 4},/obj/structure/barricade/wooden/crude,/turf/open/floor/plastic,/area/ruin/bughabitat)
"XC" = (/obj/machinery/power/port_gen/pacman,/obj/structure/cable,/obj/effect/turf_decal/siding/wideplating/light{color = "#236F26"},/turf/open/floor/plastic,/area/ruin/bughabitat)
"Yl" = (/mob/living/simple_animal/butterfly,/obj/structure/chair/pew/left{dir = 8},/turf/open/floor/plastic,/area/ruin/bughabitat)
"Yp" = (/obj/structure/window/reinforced/spawner/east,/obj/effect/turf_decal/siding/wideplating/light{color = "#236F26"; dir = 4},/turf/open/floor/iron,/area/ruin/bughabitat)
"Yu" = (/obj/item/book/manual/wiki/cytology,/obj/structure/table,/turf/open/floor/plastic,/area/ruin/bughabitat)
"Ze" = (/obj/effect/spawner/random/structure/chair_flipped,/turf/open/floor/plastic,/area/ruin/bughabitat)
"ZM" = (/obj/structure/window/reinforced/spawner/north,/obj/effect/turf_decal/siding/wideplating/light{color = "#236F26"; dir = 1},/turf/open/floor/plastic,/area/ruin/bughabitat)

(1,1,1) = {"
zGzGVXzGzGVXVXzGzGzGzGzGVXVX
VXpDpDpDpDpDpDpDpDpDpDzGzGVX
VXpDLoAtiLjLELoEYuMlpDzGzGzG
VXpDEAwOrjCGELvsTrQUpDzGzGzG
VXpDqMZMgPZMgPrYdlDEpDpDpDzG
VXpDoLfvAPbrgkYpsCTaMlaApDVX
zGbUbIfvUMHwSCUvfvfvfvYlpDVX
VXpDNacCUyNMXChkfPfvfviApDVX
VXpDgepDpDgepDEbgkfvfvBtWoVX
VXpDMlGgFPJEpDeufvtgLQnDpDVX
VXpDZecLFPeDpDcDUwpDpDpDpDzG
VXpDSWGgxvFPpDvwlkVEePpDzGzG
VXpDpDpDpDARpDpDpDpDpDpDzGzG
VXzGzGVXVXzGzGzGzGzGVXzGzGVX
"}
