//MAP CONVERTED BY dmm2tgm.py THIS HEADER COMMENT PREVENTS RECONVERSION, DO NOT REMOVE
"a" = (
/turf/template_noop,
/area/template_noop)
"b" = (
/turf/open/lava/smooth{
	initial_gas_mix = "JUNGLE_ATMOS"
	},
/area/ruin/unpowered/demonic_miner_arena)
"d" = (
/obj/structure/stone_tile/block/cracked,
/obj/structure/stone_tile/cracked{
	dir = 4
	},
/turf/open/lava/smooth{
	initial_gas_mix = "JUNGLE_ATMOS"
	},
/area/ruin/unpowered/demonic_miner_arena)
"e" = (
/obj/effect/decal/cleanable/blood/old,
/mob/living/simple_animal/hostile/imp/jungle/demonic_miner,
/turf/open/floor/cult{
	initial_gas_mix = "JUNGLE_ATMOS"
	},
/area/ruin/unpowered/demonic_miner_arena)
"f" = (
/obj/structure/stone_tile/cracked{
	dir = 4
	},
/obj/structure/stone_tile/cracked{
	dir = 8
	},
/obj/structure/stone_tile,
/turf/open/floor/cult{
	initial_gas_mix = "JUNGLE_ATMOS"
	},
/area/ruin/unpowered/demonic_miner_arena)
"j" = (
/mob/living/simple_animal/hostile/imp/jungle/demonic_miner,
/turf/open/floor/cult{
	initial_gas_mix = "JUNGLE_ATMOS"
	},
/area/ruin/unpowered/demonic_miner_arena)
"l" = (
/turf/open/floor/plating/asteroid/basalt{
	initial_gas_mix = "JUNGLE_ATMOS"
	},
/area/ruin/unpowered/demonic_miner_arena)
"o" = (
/obj/structure/stone_tile/cracked{
	dir = 1
	},
/obj/structure/stone_tile{
	dir = 8
	},
/obj/structure/stone_tile{
	dir = 4
	},
/turf/open/floor/cult{
	initial_gas_mix = "JUNGLE_ATMOS"
	},
/area/ruin/unpowered/demonic_miner_arena)
"p" = (
/obj/structure/stone_tile/slab/cracked{
	dir = 5
	},
/obj/structure/stone_tile/slab/cracked{
	dir = 9
	},
/turf/open/lava/smooth{
	initial_gas_mix = "JUNGLE_ATMOS"
	},
/area/ruin/unpowered/demonic_miner_arena)
"s" = (
/turf/open/floor/cult{
	initial_gas_mix = "JUNGLE_ATMOS"
	},
/area/ruin/unpowered/demonic_miner_arena)
"z" = (
/obj/structure/stone_tile/slab,
/turf/open/lava/smooth{
	initial_gas_mix = "JUNGLE_ATMOS"
	},
/area/ruin/unpowered/demonic_miner_arena)
"A" = (
/obj/structure/stone_tile/cracked,
/obj/structure/stone_tile/cracked{
	dir = 1
	},
/obj/structure/stone_tile/cracked{
	dir = 8
	},
/turf/open/floor/cult{
	initial_gas_mix = "JUNGLE_ATMOS"
	},
/area/ruin/unpowered/demonic_miner_arena)
"C" = (
/turf/closed/wall/mineral/cult,
/area/ruin/unpowered/demonic_miner_arena)
"H" = (
/obj/structure/stone_tile/surrounding/cracked{
	dir = 6
	},
/mob/living/simple_animal/hostile/megafauna/jungle/demonic_miner,
/turf/open/lava/smooth{
	initial_gas_mix = "JUNGLE_ATMOS"
	},
/area/ruin/unpowered/demonic_miner_arena)
"J" = (
/turf/closed/indestructible/cult,
/area/ruin/unpowered/demonic_miner_arena)
"K" = (
/obj/effect/decal/cleanable/blood/old,
/turf/open/floor/plating/asteroid/basalt{
	initial_gas_mix = "JUNGLE_ATMOS"
	},
/area/ruin/unpowered/demonic_miner_arena)
"L" = (
/obj/structure/stone_tile/cracked,
/obj/structure/stone_tile{
	dir = 4
	},
/obj/structure/stone_tile{
	dir = 1
	},
/turf/open/floor/cult{
	initial_gas_mix = "JUNGLE_ATMOS"
	},
/area/ruin/unpowered/demonic_miner_arena)
"T" = (
/obj/effect/decal/cleanable/blood/old,
/turf/open/floor/cult{
	initial_gas_mix = "JUNGLE_ATMOS"
	},
/area/ruin/unpowered/demonic_miner_arena)
"W" = (
/obj/structure/stone_tile/slab/cracked,
/turf/open/lava/smooth{
	initial_gas_mix = "JUNGLE_ATMOS"
	},
/area/ruin/unpowered/demonic_miner_arena)

(1,1,1) = {"
a
a
a
a
a
a
a
a
a
a
l
l
l
l
l
l
l
l
l
a
a
a
a
a
a
a
a
a
a
"}
(2,1,1) = {"
a
a
a
a
a
a
a
l
l
l
l
l
l
l
l
l
l
l
l
l
l
l
a
a
a
a
a
a
a
"}
(3,1,1) = {"
a
a
a
a
a
l
l
l
l
l
l
l
l
b
J
b
l
l
K
l
l
l
l
l
a
a
a
a
a
"}
(4,1,1) = {"
a
a
a
a
l
l
l
l
l
l
l
l
b
b
J
b
b
l
l
l
l
l
l
l
l
a
a
a
a
"}
(5,1,1) = {"
a
a
a
l
l
l
l
C
C
l
l
l
J
J
J
J
J
l
l
l
C
C
l
l
l
l
a
a
a
"}
(6,1,1) = {"
a
a
l
l
l
l
l
K
l
l
l
l
l
l
l
l
l
l
l
l
l
l
l
l
l
l
l
a
a
"}
(7,1,1) = {"
a
a
l
l
l
l
l
l
l
l
l
K
l
l
l
l
l
l
l
l
l
l
l
l
l
l
l
a
a
"}
(8,1,1) = {"
a
l
l
l
C
l
l
l
l
l
l
l
l
l
l
l
l
l
l
l
l
l
l
l
C
l
l
l
a
"}
(9,1,1) = {"
a
l
l
l
C
l
l
l
J
J
b
b
b
l
l
l
b
b
b
J
J
l
l
l
C
l
l
l
a
"}
(10,1,1) = {"
a
l
l
l
l
l
l
l
J
b
b
b
b
K
l
l
b
b
b
b
J
l
l
l
l
l
l
l
a
"}
(11,1,1) = {"
l
l
l
l
l
l
l
l
b
b
b
l
K
l
K
l
l
l
b
b
b
l
K
l
l
l
l
l
l
"}
(12,1,1) = {"
l
l
l
l
l
l
l
l
b
b
l
l
l
l
l
l
l
l
l
b
b
l
l
l
l
l
l
l
l
"}
(13,1,1) = {"
l
l
l
b
J
l
l
l
b
b
l
l
l
e
s
j
l
l
l
b
b
l
l
l
J
b
l
l
l
"}
(14,1,1) = {"
l
l
b
b
J
l
l
l
l
K
l
l
j
o
W
f
e
K
l
l
l
l
l
l
J
b
b
l
l
"}
(15,1,1) = {"
l
l
J
J
J
l
l
l
l
l
l
l
T
d
H
z
s
l
l
K
l
l
l
l
J
J
J
l
l
"}
(16,1,1) = {"
l
l
b
b
J
l
l
l
l
l
l
l
j
L
p
A
j
l
l
l
l
l
l
l
J
b
b
l
l
"}
(17,1,1) = {"
l
l
l
b
J
l
l
l
b
b
l
l
l
j
T
e
l
K
l
b
b
l
l
l
J
b
l
l
l
"}
(18,1,1) = {"
l
l
l
l
l
l
l
l
b
b
l
K
l
l
l
l
l
l
l
b
b
l
l
l
l
l
l
l
l
"}
(19,1,1) = {"
l
l
l
K
l
l
l
l
b
b
b
l
l
l
K
l
l
l
b
b
b
l
l
l
l
K
l
l
l
"}
(20,1,1) = {"
a
l
l
l
l
K
l
l
J
b
b
b
b
l
l
l
b
b
b
b
J
l
l
l
l
l
l
l
a
"}
(21,1,1) = {"
a
l
l
l
C
l
l
l
J
J
b
b
b
l
l
l
b
b
b
J
J
l
l
l
C
l
l
l
a
"}
(22,1,1) = {"
a
l
l
l
C
l
l
l
l
l
l
l
l
l
l
l
l
l
l
l
K
l
l
l
C
l
l
l
a
"}
(23,1,1) = {"
a
a
l
l
l
l
l
l
l
l
l
l
l
l
l
l
l
l
l
K
l
l
l
l
l
l
l
a
a
"}
(24,1,1) = {"
a
a
l
l
l
l
l
l
l
l
l
l
l
l
l
l
l
l
l
l
l
l
l
l
l
l
l
a
a
"}
(25,1,1) = {"
a
a
a
l
l
l
l
C
C
l
l
l
J
J
J
J
J
l
l
l
C
C
l
l
l
l
a
a
a
"}
(26,1,1) = {"
a
a
a
a
l
l
l
l
l
l
l
l
b
b
J
b
b
l
l
l
l
l
l
l
l
a
a
a
a
"}
(27,1,1) = {"
a
a
a
a
a
l
l
l
l
l
l
l
l
b
J
b
l
l
l
l
l
l
l
l
a
a
a
a
a
"}
(28,1,1) = {"
a
a
a
a
a
a
a
l
l
l
l
l
l
l
l
l
l
l
l
l
l
l
a
a
a
a
a
a
a
"}
(29,1,1) = {"
a
a
a
a
a
a
a
a
a
a
l
l
l
l
l
l
l
l
l
a
a
a
a
a
a
a
a
a
a
"}
