"as" = (/obj/item/kirbyplants/random,/obj/machinery/light/small/directional/east,/turf/open/floor/iron/grimy,/area/ruin/powered/bluespace_lab)
"bO" = (/obj/structure/closet/radiation,/obj/effect/turf_decal/delivery,/turf/open/floor/iron/dark/textured_large,/area/ruin/powered/bluespace_lab)
"cf" = (/obj/structure/lattice,/turf/open/floor/plating/dirt/jungle,/area/ruin/powered/bluespace_lab)
"cu" = (/obj/effect/turf_decal/stripes/line,/obj/effect/turf_decal/stripes/corner{dir = 4},/obj/effect/turf_decal/stripes/corner{dir = 1},/turf/open/floor/engine,/area/ruin/powered/bluespace_lab)
"cH" = (/turf/open/floor/iron/grimy,/area/ruin/powered/bluespace_lab)
"cR" = (/mob/living/simple_animal/hostile/megafauna/jungle/bluespace_spirit,/turf/open/floor/plating/dirt/jungle,/area/ruin/powered/bluespace_lab)
"cS" = (/obj/structure/railing{dir = 8; pixel_x = -3},/obj/effect/turf_decal/stripes/end{dir = 4},/turf/open/floor/engine,/area/ruin/powered/bluespace_lab)
"dh" = (/obj/effect/turf_decal/stripes/line{dir = 6},/obj/effect/turf_decal/stripes/corner{dir = 1},/turf/open/floor/engine,/area/ruin/powered/bluespace_lab)
"dy" = (/obj/structure/girder,/turf/open/floor/plating/airless,/area/ruin/powered/bluespace_lab)
"dS" = (/obj/structure/table_frame,/turf/open/floor/plating/airless,/area/ruin/powered/bluespace_lab)
"fs" = (/obj/machinery/computer{desc = "A computer long since rendered non-functional due to lack of maintenance. Spitting out error messages."; name = "Broken Computer"},/turf/open/floor/iron/grimy,/area/ruin/powered/bluespace_lab)
"gm" = (/obj/effect/turf_decal/stripes/line{dir = 4},/obj/effect/turf_decal/stripes/line{dir = 8},/turf/open/floor/engine,/area/ruin/powered/bluespace_lab)
"hJ" = (/obj/machinery/door/airlock/vault{name = "reinforced door"},/turf/open/floor/engine,/area/ruin/powered/bluespace_lab)
"jw" = (/obj/item/kirbyplants/random,/turf/open/floor/iron/grimy,/area/ruin/powered/bluespace_lab)
"jC" = (/obj/structure/closet/radiation,/obj/effect/turf_decal/delivery,/obj/machinery/light/small/directional/west,/turf/open/floor/iron/dark/textured_large,/area/ruin/powered/bluespace_lab)
"jF" = (/turf/template_noop,/area/template_noop)
"mi" = (/obj/structure/foamedmetal,/turf/open/floor/plating/airless,/area/ruin/powered/bluespace_lab)
"nh" = (/obj/machinery/light/small/directional/west,/turf/open/floor/iron/stairs/left,/area/ruin/powered/bluespace_lab)
"oK" = (/obj/effect/turf_decal/stripes/line{dir = 1},/obj/structure/table/reinforced,/obj/effect/turf_decal/stripes/line,/turf/open/floor/engine,/area/ruin/powered/bluespace_lab)
"pj" = (/obj/item/target/clown,/obj/effect/turf_decal/delivery,/turf/open/floor/iron/dark/textured_large,/area/ruin/powered/bluespace_lab)
"pp" = (/obj/effect/turf_decal/stripes/line{dir = 1},/obj/structure/table/reinforced,/obj/effect/turf_decal/stripes/line,/obj/item/anomaly_neutralizer,/turf/open/floor/engine,/area/ruin/powered/bluespace_lab)
"pC" = (/obj/effect/turf_decal/stripes/line{dir = 1},/obj/structure/railing{dir = 4; pixel_x = 3},/obj/structure/railing{dir = 8; pixel_x = -3},/obj/effect/turf_decal/stripes/line,/turf/open/floor/engine,/area/ruin/powered/bluespace_lab)
"pN" = (/obj/structure/filingcabinet,/turf/open/floor/iron/grimy,/area/ruin/powered/bluespace_lab)
"qs" = (/turf/closed/wall/r_wall,/area/ruin/powered/bluespace_lab)
"qB" = (/obj/machinery/light/small/directional/south,/turf/open/floor/iron/grimy,/area/ruin/powered/bluespace_lab)
"sm" = (/obj/machinery/computer{desc = "A computer long since rendered non-functional due to lack of maintenance. Spitting out error messages."; dir = 1; name = "Broken Computer"},/turf/open/floor/iron/grimy,/area/ruin/powered/bluespace_lab)
"sz" = (/obj/effect/turf_decal/stripes/line,/turf/open/floor/engine,/area/ruin/powered/bluespace_lab)
"sA" = (/turf/open/floor/iron/stairs/medium,/area/ruin/powered/bluespace_lab)
"ty" = (/obj/structure/chair/office{dir = 1},/turf/open/floor/iron/grimy,/area/ruin/powered/bluespace_lab)
"vd" = (/obj/effect/turf_decal/stripes/line{dir = 5},/turf/open/floor/engine,/area/ruin/powered/bluespace_lab)
"vO" = (/obj/effect/turf_decal/stripes/line{dir = 8},/obj/effect/turf_decal/stripes/corner,/turf/open/floor/engine,/area/ruin/powered/bluespace_lab)
"xe" = (/obj/structure/railing{dir = 4; pixel_x = 3},/obj/effect/turf_decal/stripes/end{dir = 8},/turf/open/floor/engine,/area/ruin/powered/bluespace_lab)
"ys" = (/turf/open/floor/plating/dirt/jungle,/area/ruin/powered/bluespace_lab)
"yG" = (/obj/effect/turf_decal/stripes/corner,/obj/effect/turf_decal/stripes/corner{dir = 8},/turf/open/floor/engine,/area/ruin/powered/bluespace_lab)
"zz" = (/obj/effect/turf_decal/delivery,/obj/item/target/syndicate,/turf/open/floor/iron/dark/textured_large,/area/ruin/powered/bluespace_lab)
"Al" = (/obj/machinery/light/floor,/turf/open/floor/iron/grimy,/area/ruin/powered/bluespace_lab)
"Aq" = (/obj/structure/closet/emcloset,/obj/effect/turf_decal/delivery,/turf/open/floor/iron/dark/textured_large,/area/ruin/powered/bluespace_lab)
"Az" = (/obj/structure/table/reinforced,/obj/item/pen,/obj/item/paper/crumpled,/turf/open/floor/iron/grimy,/area/ruin/powered/bluespace_lab)
"Cg" = (/obj/structure/closet/firecloset,/obj/effect/turf_decal/delivery,/turf/open/floor/iron/dark/textured_large,/area/ruin/powered/bluespace_lab)
"Ef" = (/obj/structure/frame/computer{anchored = 1},/turf/open/floor/iron/grimy,/area/ruin/powered/bluespace_lab)
"En" = (/obj/item/kirbyplants/random,/obj/machinery/light/small/directional/west,/turf/open/floor/iron/grimy,/area/ruin/powered/bluespace_lab)
"EH" = (/obj/effect/turf_decal/stripes/line{dir = 1},/obj/structure/table/reinforced,/obj/effect/turf_decal/stripes/line,/obj/item/analyzer{pixel_x = 2; pixel_y = 3},/turf/open/floor/engine,/area/ruin/powered/bluespace_lab)
"EQ" = (/obj/effect/turf_decal/stripes/line{dir = 1},/turf/open/floor/engine,/area/ruin/powered/bluespace_lab)
"Fn" = (/obj/effect/turf_decal/stripes/line{dir = 4},/obj/effect/turf_decal/stripes/corner{dir = 8},/turf/open/floor/engine,/area/ruin/powered/bluespace_lab)
"Go" = (/obj/effect/turf_decal/stripes/line{dir = 9},/turf/open/floor/engine,/area/ruin/powered/bluespace_lab)
"Hm" = (/obj/machinery/door/window/eastleft,/turf/open/floor/iron/grimy,/area/ruin/powered/bluespace_lab)
"Jt" = (/obj/structure/frame/computer{anchored = 1; dir = 1},/turf/open/floor/iron/grimy,/area/ruin/powered/bluespace_lab)
"JG" = (/obj/effect/turf_decal/stripes/line{dir = 10},/obj/effect/turf_decal/stripes/corner{dir = 4},/turf/open/floor/engine,/area/ruin/powered/bluespace_lab)
"JO" = (/obj/machinery/light/small/directional/west,/turf/open/floor/iron/grimy,/area/ruin/powered/bluespace_lab)
"KC" = (/obj/machinery/light/small/directional/east,/turf/open/floor/iron/grimy,/area/ruin/powered/bluespace_lab)
"MM" = (/obj/effect/turf_decal/stripes/line,/obj/effect/turf_decal/stripes/corner{dir = 4},/obj/effect/turf_decal/stripes/corner{dir = 1},/obj/machinery/light/small/directional/south,/turf/open/floor/engine,/area/ruin/powered/bluespace_lab)
"NE" = (/turf/open/floor/plating/airless,/area/ruin/powered/bluespace_lab)
"NQ" = (/obj/machinery/light/small/directional/east,/turf/open/floor/iron/stairs/right,/area/ruin/powered/bluespace_lab)
"Pi" = (/obj/structure/chair/office,/turf/open/floor/iron/grimy,/area/ruin/powered/bluespace_lab)
"Py" = (/obj/machinery/light/small/directional/north,/turf/open/floor/iron/grimy,/area/ruin/powered/bluespace_lab)
"Qx" = (/obj/effect/turf_decal/stripes/line,/obj/effect/turf_decal/stripes/line{dir = 1},/turf/open/floor/engine,/area/ruin/powered/bluespace_lab)
"RD" = (/obj/structure/girder/reinforced,/turf/open/floor/plating/airless,/area/ruin/powered/bluespace_lab)
"Vi" = (/obj/effect/turf_decal/delivery,/obj/item/target,/turf/open/floor/iron/dark/textured_large,/area/ruin/powered/bluespace_lab)
"Vo" = (/obj/effect/turf_decal/stripes/line{dir = 8},/obj/effect/turf_decal/stripes/line{dir = 4},/turf/open/floor/engine,/area/ruin/powered/bluespace_lab)
"Xh" = (/obj/structure/table/reinforced,/turf/open/floor/iron/grimy,/area/ruin/powered/bluespace_lab)
"Ya" = (/turf/open/floor/plating/airless{icon_state = "platingdmg2"},/area/ruin/powered/bluespace_lab)
"YQ" = (/obj/effect/turf_decal/delivery,/obj/item/target/alien/anchored,/turf/open/floor/iron/dark/textured_large,/area/ruin/powered/bluespace_lab)

(1,1,1) = {"
qsqsqsqsqsqsqsqsqsqsqsqsqsqsqsqsqsqsqsqsqsqsqsqsqs
qsmimimimimidydymimimimimidymimimidymimimimimimiqs
qsmiqsqsqsqsqsqsqsqsqsqsqsqsqsqsqsqsqsqsqsqsqsmiqs
qsdyqsjwcHPycHcHcHcHPycHcHcHPycHcHcHcHPycHjwqsmiqs
qsmiqscHcHcHcHcHcHcHcHcHcHcHcHcHcHcHcHcHcHcHqsdyqs
qsmiqsJOcHcHPicHcHPicHcHcHcHcHPicHcHPicHcHKCqsmiqs
qsmiqscHcHJtsmsmJtsmJtcHcHcHsmsmsmsmsmJtcHcHqsmiqs
qsmiqscHcHfsfsEfEfEffscHNENEEffsEffsEffscHcHqsdyqs
qsdyqscHcHcHtycHcHtycHNEYacfNEtycHcHtycHcHcHqsdyqs
qsdyqsEncHcHcHcHAlcHNEcfcRcfNEcHAlcHcHcHcHasqsmiqs
qsmiqscHcHcHPicHcHPiNEYacfcfNEPicHcHPicHcHcHqsmiqs
qsmiqscHcHJtsmsmJtsmJtNENENEsmsmsmsmsmJtcHcHqsmiqs
qsdyqscHcHfsfsEfEfEffscHNEcHEffsEffsEffscHcHqsmiqs
qsmiqsJOcHcHtycHcHtycHcHcHcHcHtycHcHtycHcHKCqsmiqs
qsmiqscHcHcHcHcHcHcHcHcHcHcHcHcHcHcHcHcHcHcHqsdyqs
qsmiqscHcHcHcHcHcHcHcHcHqBcHqBcHcHcHcHqBcHjwqsdyqs
qsmiqsxeEHoKoKpCoKppoKcSqsjwqsqsqsqshJqsqsqsqsmiqs
qsmiqsnhsAsAsAsAsAsAsANQqsqsqsmiqsjCgmAqqsmimimiqs
qsmiqsGoEQEQEQEQEQEQEQvdqsmimidyqsbOgmCgqsdyqsqsqs
qsdyqsvOszyGszyGszyGszFnqsdyqsqsqsqshJqsqsqsqsjFjF
qsdyqsVopjVoYQVozzVoVigmqsmiqspNPyXhNEjwqsjFjFjFjF
qsmiqsJGQxMMQxcuQxMMQxdhqsmiqscHPiHmcfcHqsysjFjFjF
qsmiqsqsqsqsqsqsqsqsqsqsqsmiqsXhAzdSYacfRDysjFjFjF
qsmidymidymimimimimidydymimiqscHYacfcfysysjFjFjFjF
qsqsqsqsqsqsqsqsqsqsqsqsqsqsqsRDqsysysysjFjFjFjFjF
"}
