"a" = (/turf/template_noop,/area/template_noop)
"b" = (/obj/item/scalpel/alien,/obj/item/surgical_drapes,/turf/open/floor/plating/abductor{initial_gas_mix = "LAVALAND_ATMOS"},/area/ruin/unpowered)
"d" = (/obj/machinery/abductor/gland_dispenser,/turf/open/floor/plating/abductor{initial_gas_mix = "LAVALAND_ATMOS"},/area/ruin/unpowered)
"g" = (/turf/closed/wall/mineral/abductor,/area/ruin/unpowered)
"h" = (/turf/closed/mineral/random/jungle,/area/ruin)
"j" = (/obj/structure/bed/abductor,/turf/open/floor/plating/abductor{initial_gas_mix = "LAVALAND_ATMOS"},/area/ruin/unpowered)
"p" = (/turf/closed/mineral/random/jungle,/area/mine/unexplored/planetgeneration/nogen)
"q" = (/obj/structure/table/optable/abductor,/obj/item/cautery/alien,/turf/open/floor/plating/abductor{initial_gas_mix = "LAVALAND_ATMOS"},/area/ruin/unpowered)
"t" = (/obj/machinery/abductor/experiment{team_number = 100},/turf/open/floor/plating/abductor{initial_gas_mix = "LAVALAND_ATMOS"},/area/ruin/unpowered)
"v" = (/obj/structure/closet/abductor,/turf/open/floor/plating/abductor{initial_gas_mix = "LAVALAND_ATMOS"},/area/ruin/unpowered)
"E" = (/obj/structure/table/abductor,/obj/item/storage/box/alienhandcuffs,/turf/open/floor/plating/abductor{initial_gas_mix = "LAVALAND_ATMOS"},/area/ruin/unpowered)
"F" = (/obj/item/hemostat/alien,/turf/open/floor/plating/abductor{initial_gas_mix = "LAVALAND_ATMOS"},/area/ruin/unpowered)
"G" = (/obj/machinery/abductor/pad{team_number = 100},/turf/open/floor/plating/abductor{initial_gas_mix = "LAVALAND_ATMOS"},/area/ruin/unpowered)
"N" = (/obj/effect/mob_spawn/corpse/human/abductor,/turf/open/floor/plating/abductor{initial_gas_mix = "LAVALAND_ATMOS"},/area/ruin/unpowered)
"P" = (/turf/open/floor/plating/dirt/jungle,/area/mine/unexplored/planetgeneration/nogen)
"V" = (/turf/open/floor/plating/abductor{initial_gas_mix = "LAVALAND_ATMOS"},/area/ruin/unpowered)
"W" = (/obj/structure/table/abductor,/obj/item/surgicaldrill/alien,/obj/item/circular_saw/alien,/turf/open/floor/plating/abductor{initial_gas_mix = "LAVALAND_ATMOS"},/area/ruin/unpowered)
"X" = (/obj/item/retractor/alien,/obj/item/paper/guides/antag/abductor,/turf/open/floor/plating/abductor{initial_gas_mix = "LAVALAND_ATMOS"},/area/ruin/unpowered)

(1,1,1) = {"
aappppppaaaaaaaaaaaaaaaaaaaaaa
apppppppppppppaaaaaaaaaaaaaaaa
pppgggggPPPPPPPPPPPaaaaaaaaaaa
ppggtVGggPPPPPPPPPPPPPPaaaaaaa
ppppVFNvgPPPPPPPPPPPPPPPPPPaaa
ppppVqVEgPPPPPPPPPPPPPPPPPPPPa
pppphbXvgPPPPPPPPPPPPPPPPaaaaa
ppppdWjggPPPPPPPPPPPPaaaaaaaaa
apppggggPPppppppaaaaaaaaaaaaaa
aapppppppppaaaaaaaaaaaaaaaaaaa
"}
