//MAP CONVERTED BY dmm2tgm.py THIS HEADER COMMENT PREVENTS RECONVERSION, DO NOT REMOVE
"a" = (
/turf/template_noop,
/area/template_noop)
"b" = (
/obj/structure/frame/computer{
	dir = 1
	},
/turf/open/floor/plating/snowed/smoothed,
/area/ruin/unpowered/ice_spiders)
"c" = (
/obj/structure/fluff{
	desc = "They seem to pulse slightly with an inner life.";
	icon = 'icons/effects/effects.dmi';
	icon_state = "eggs";
	name = "egg cluster"
	},
/obj/structure/spider/stickyweb,
/obj/structure/table_frame,
/turf/open/floor/plating/asteroid/snow/atmosphere,
/area/ruin/unpowered/ice_spiders)
"d" = (
/obj/structure/fluff{
	desc = "They seem to pulse slightly with an inner life.";
	icon = 'icons/effects/effects.dmi';
	icon_state = "eggs";
	name = "egg cluster"
	},
/mob/living/simple_animal/hostile/giant_spider/nurse/ice{
	speak_chance = 0
	},
/turf/open/floor/plating/asteroid/snow/atmosphere,
/area/ruin/unpowered/ice_spiders)
"e" = (
/obj/structure/spider/stickyweb,
/obj/structure/spider/cocoon,
/turf/open/floor/plating/asteroid/snow/atmosphere,
/area/ruin/unpowered/ice_spiders)
"f" = (
/obj/structure/spider/cocoon,
/obj/structure/spider/stickyweb,
/mob/living/simple_animal/hostile/giant_spider/hunter/ice{
	speak_chance = 0
	},
/turf/open/floor/plating/asteroid/snow/atmosphere,
/area/ruin/unpowered/ice_spiders)
"g" = (
/obj/structure/frame/machine,
/turf/open/floor/plating/snowed/smoothed,
/area/ruin/unpowered/ice_spiders)
"h" = (
/obj/structure/fluff{
	desc = "They seem to pulse slightly with an inner life.";
	icon = 'icons/effects/effects.dmi';
	icon_state = "eggs";
	name = "egg cluster"
	},
/obj/structure/spider/stickyweb,
/mob/living/simple_animal/hostile/giant_spider/nurse/ice{
	speak_chance = 0
	},
/turf/open/floor/plating/asteroid/snow/atmosphere,
/area/ruin/unpowered/ice_spiders)
"i" = (
/obj/structure/frame/machine,
/turf/open/floor/plating/ice/smooth,
/area/ruin/unpowered/ice_spiders)
"j" = (
/obj/structure/flora/rock/pile/icy,
/turf/open/floor/plating/asteroid/snow/atmosphere,
/area/ruin/unpowered/ice_spiders)
"k" = (
/obj/structure/spider/stickyweb,
/obj/structure/flora/rock/pile/icy,
/turf/open/floor/plating/asteroid/snow/atmosphere,
/area/ruin/unpowered/ice_spiders)
"n" = (
/turf/closed/mineral/snowmountain,
/area/ruin/unpowered/ice_spiders)
"o" = (
/obj/structure/spider/stickyweb,
/obj/structure/fluff{
	desc = "They seem to pulse slightly with an inner life.";
	icon = 'icons/effects/effects.dmi';
	icon_state = "eggs";
	name = "egg cluster"
	},
/turf/open/floor/plating/asteroid/snow/atmosphere,
/area/ruin/unpowered/ice_spiders)
"p" = (
/obj/structure/spider/stickyweb,
/obj/structure/fluff{
	desc = "They seem to pulse slightly with an inner life.";
	icon = 'icons/effects/effects.dmi';
	icon_state = "eggs";
	name = "egg cluster"
	},
/mob/living/simple_animal/hostile/giant_spider/ice{
	speak_chance = 0
	},
/obj/item/organ/heart/spider_mother,
/turf/open/floor/plating/asteroid/snow/atmosphere,
/area/ruin/unpowered/ice_spiders)
"q" = (
/turf/open/floor/plating/ice/smooth,
/area/ruin/unpowered/ice_spiders)
"r" = (
/obj/structure/windoor_assembly{
	dir = 4
	},
/turf/open/floor/plating/ice/smooth,
/area/ruin/unpowered/ice_spiders)
"t" = (
/obj/structure/girder,
/obj/structure/grille,
/turf/open/floor/plating/snowed/smoothed,
/area/ruin/unpowered/ice_spiders)
"u" = (
/obj/item/shard,
/turf/open/floor/plating/asteroid/snow/atmosphere,
/area/ruin/unpowered/ice_spiders)
"w" = (
/obj/structure/spider/stickyweb,
/turf/open/floor/plating/ice/smooth,
/area/ruin/unpowered/ice_spiders)
"x" = (
/obj/structure/spider/cocoon,
/obj/structure/spider/stickyweb,
/mob/living/simple_animal/hostile/giant_spider/ice{
	speak_chance = 0
	},
/turf/open/floor/plating/asteroid/snow/atmosphere,
/area/ruin/unpowered/ice_spiders)
"y" = (
/turf/open/floor/plating/snowed/smoothed,
/area/ruin/unpowered/ice_spiders)
"z" = (
/obj/structure/fluff{
	desc = "They seem to pulse slightly with an inner life.";
	icon = 'icons/effects/effects.dmi';
	icon_state = "eggs";
	name = "egg cluster"
	},
/turf/open/floor/plating/asteroid/snow/atmosphere,
/area/ruin/unpowered/ice_spiders)
"A" = (
/obj/structure/barricade/wooden/snowed,
/turf/open/floor/plating/snowed/smoothed,
/area/ruin/unpowered/ice_spiders)
"B" = (
/obj/structure/statue/snow/snowman,
/turf/open/floor/plating/asteroid/snow/atmosphere,
/area/ruin/unpowered/ice_spiders)
"C" = (
/mob/living/simple_animal/hostile/giant_spider/ice{
	speak_chance = 0
	},
/turf/open/floor/plating/asteroid/snow/atmosphere,
/area/ruin/unpowered/ice_spiders)
"D" = (
/obj/structure/frame/computer{
	dir = 1
	},
/obj/structure/spider/stickyweb,
/turf/open/floor/plating/asteroid/snow/atmosphere,
/area/ruin/unpowered/ice_spiders)
"E" = (
/obj/effect/mob_spawn/corpse/human/geneticist,
/obj/structure/bed/maint,
/obj/effect/decal/cleanable/cobweb/cobweb2,
/turf/open/floor/plating/snowed/smoothed,
/area/ruin/unpowered/ice_spiders)
"F" = (
/obj/structure/spider/stickyweb,
/obj/structure/spider/cocoon,
/mob/living/simple_animal/hostile/giant_spider/hunter/ice{
	speak_chance = 0
	},
/turf/open/floor/plating/asteroid/snow/atmosphere,
/area/ruin/unpowered/ice_spiders)
"H" = (
/obj/structure/fluff/iced_abductor,
/turf/open/floor/plating/asteroid/snow/atmosphere,
/area/ruin/unpowered/ice_spiders)
"I" = (
/obj/structure/spider/stickyweb,
/obj/structure/ice_stasis,
/turf/open/floor/plating/ice/smooth,
/area/ruin/unpowered/ice_spiders)
"J" = (
/obj/structure/spider/stickyweb,
/mob/living/simple_animal/hostile/giant_spider/nurse/ice{
	speak_chance = 0
	},
/turf/open/floor/plating/asteroid/snow/atmosphere,
/area/ruin/unpowered/ice_spiders)
"K" = (
/obj/structure/table/wood,
/obj/item/paper/crumpled/bloody{
	info = "If you're reading this, I am probaby dead and you have aready found my body. Run. Just run. Our experiments failed and spiders breached contaiment. We are all doomed. ";
	text = ""
	},
/obj/machinery/light/small/broken{
	dir = 4
	},
/turf/open/floor/plating/snowed/smoothed,
/area/ruin/unpowered/ice_spiders)
"L" = (
/obj/structure/door_assembly/door_assembly_vault{
	anchored = 1
	},
/obj/structure/spider/stickyweb,
/turf/open/floor/plating/asteroid/snow/atmosphere,
/area/ruin/unpowered/ice_spiders)
"M" = (
/obj/structure/spider/stickyweb,
/mob/living/simple_animal/hostile/giant_spider/ice{
	speak_chance = 0
	},
/turf/open/floor/plating/asteroid/snow/atmosphere,
/area/ruin/unpowered/ice_spiders)
"N" = (
/obj/structure/spider/cocoon,
/turf/open/floor/plating/asteroid/snow/atmosphere,
/area/ruin/unpowered/ice_spiders)
"O" = (
/obj/structure/ice_stasis,
/turf/open/floor/plating/asteroid/snow/atmosphere,
/area/ruin/unpowered/ice_spiders)
"P" = (
/obj/structure/spider/stickyweb,
/mob/living/simple_animal/hostile/giant_spider/hunter/ice{
	speak_chance = 0
	},
/turf/open/floor/plating/ice/smooth,
/area/ruin/unpowered/ice_spiders)
"Q" = (
/obj/structure/spider/stickyweb,
/turf/open/floor/plating/snowed/smoothed,
/area/ruin/unpowered/ice_spiders)
"R" = (
/obj/structure/spider/stickyweb,
/obj/structure/flora/rock/icy,
/turf/open/floor/plating/asteroid/snow/atmosphere,
/area/ruin/unpowered/ice_spiders)
"S" = (
/mob/living/simple_animal/hostile/giant_spider/hunter/ice{
	speak_chance = 0
	},
/turf/open/floor/plating/asteroid/snow/atmosphere,
/area/ruin/unpowered/ice_spiders)
"T" = (
/obj/structure/barricade/wooden/snowed,
/obj/structure/spider/stickyweb,
/turf/open/floor/plating/asteroid/snow/atmosphere,
/area/ruin/unpowered/ice_spiders)
"U" = (
/obj/structure/door_assembly/door_assembly_science,
/turf/open/floor/plating/snowed/smoothed,
/area/ruin/unpowered/ice_spiders)
"V" = (
/turf/open/floor/plating/asteroid/snow/atmosphere,
/area/ruin/unpowered/ice_spiders)
"W" = (
/turf/closed/indestructible/rock/snow/ice/ore,
/area/ruin/unpowered/ice_spiders)
"X" = (
/obj/structure/spider/stickyweb,
/turf/open/floor/plating/asteroid/snow/atmosphere,
/area/ruin/unpowered/ice_spiders)
"Y" = (
/obj/structure/table/wood,
/obj/effect/decal/cleanable/cobweb,
/turf/open/floor/plating/snowed/smoothed,
/area/ruin/unpowered/ice_spiders)
"Z" = (
/obj/structure/bookcase,
/turf/open/floor/plating/snowed/smoothed,
/area/ruin/unpowered/ice_spiders)

(1,1,1) = {"
a
a
a
a
a
a
a
a
a
a
n
n
n
n
a
a
a
a
a
"}
(2,1,1) = {"
a
a
n
n
n
n
a
a
a
W
W
W
W
n
n
a
a
a
a
"}
(3,1,1) = {"
a
n
n
n
n
n
n
n
W
W
S
O
W
n
W
V
V
a
a
"}
(4,1,1) = {"
n
n
W
W
W
W
W
n
W
H
e
X
W
W
W
n
V
V
a
"}
(5,1,1) = {"
n
W
W
c
x
J
W
W
W
V
M
q
P
W
n
n
n
V
a
"}
(6,1,1) = {"
n
W
N
z
X
o
D
W
F
X
X
M
n
W
n
n
n
W
a
"}
(7,1,1) = {"
n
W
h
f
V
N
p
W
w
I
W
n
n
n
V
n
W
W
a
"}
(8,1,1) = {"
n
W
i
q
J
B
W
W
W
W
W
n
n
X
V
W
W
n
a
"}
(9,1,1) = {"
a
W
W
r
X
W
W
n
n
n
W
W
W
Q
X
W
n
a
a
"}
(10,1,1) = {"
a
n
W
X
u
W
n
n
n
n
n
n
W
U
Q
W
a
a
a
"}
(11,1,1) = {"
a
a
W
V
V
W
W
n
n
n
n
W
W
Q
U
W
n
a
a
"}
(12,1,1) = {"
a
W
W
V
X
R
W
n
n
W
W
W
X
V
V
W
n
n
a
"}
(13,1,1) = {"
a
W
j
X
X
C
W
n
W
W
V
R
X
X
M
W
W
n
n
"}
(14,1,1) = {"
a
W
X
V
V
W
W
n
W
X
M
X
X
j
V
X
W
W
n
"}
(15,1,1) = {"
a
W
V
X
W
W
n
W
W
V
X
X
X
X
V
X
X
W
n
"}
(16,1,1) = {"
a
W
X
X
W
n
n
W
X
k
X
V
X
X
X
X
V
W
n
"}
(17,1,1) = {"
W
W
V
X
W
n
n
W
V
X
X
W
W
W
X
S
W
W
n
"}
(18,1,1) = {"
W
X
X
V
W
W
n
W
V
X
W
W
n
W
W
W
W
n
n
"}
(19,1,1) = {"
W
W
S
X
q
W
n
W
M
V
W
n
n
n
n
n
n
n
a
"}
(20,1,1) = {"
a
W
k
X
w
W
W
W
W
L
W
W
W
W
W
W
n
a
a
"}
(21,1,1) = {"
W
W
R
X
X
j
W
W
W
V
V
X
T
A
Y
W
W
W
a
"}
(22,1,1) = {"
W
d
N
X
X
X
W
W
q
X
X
X
A
Z
y
y
b
W
a
"}
(23,1,1) = {"
W
e
X
V
X
V
V
X
X
V
W
W
W
t
K
y
g
W
a
"}
(24,1,1) = {"
W
W
o
W
W
M
X
V
X
W
W
n
W
W
W
E
W
W
a
"}
(25,1,1) = {"
a
W
W
W
W
W
W
W
W
W
n
a
a
a
W
W
W
a
a
"}
