"a" = (/turf/template_noop,/area/template_noop)
"f" = (/turf/closed/mineral/random/jungle,/area/ruin/jungle_monkey_altar)
"o" = (/mob/living/simple_animal/hostile/gorilla/jungle,/turf/open/floor/plating/dirt/jungle,/area/ruin/jungle_monkey_altar)
"x" = (/obj/structure/table/wood,/obj/item/gun/magic/staff/honk,/turf/open/floor/plating/dirt/jungle,/area/ruin/jungle_monkey_altar)
"y" = (/obj/structure/statue/bananium/clown,/turf/open/floor/plating/dirt/jungle,/area/ruin/jungle_monkey_altar)
"C" = (/obj/structure/table/wood,/obj/item/reagent_containers/spray/waterflower/superlube,/turf/open/floor/plating/dirt/jungle,/area/ruin/jungle_monkey_altar)
"I" = (/obj/structure/table/wood,/obj/item/grown/bananapeel/bluespace,/turf/open/floor/plating/dirt/jungle,/area/ruin/jungle_monkey_altar)
"Q" = (/mob/living/carbon/human/species/monkey/angry,/turf/open/floor/plating/dirt/jungle,/area/ruin/jungle_monkey_altar)
"T" = (/obj/structure/table/wood,/obj/item/clothing/shoes/clown_shoes/banana_shoes,/turf/open/floor/plating/dirt/jungle,/area/ruin/jungle_monkey_altar)
"X" = (/turf/open/floor/plating/dirt/jungle,/area/ruin/jungle_monkey_altar)

(1,1,1) = {"
afffffffaa
ffXQXXQfff
foXXXxXXof
fXQXIyCXXf
fXXoXTXQof
ffXXXXQXXf
fffXQXXfff
fffffXfffa
afffXoffaa
aaffQffaaa
"}
