//MAP CONVERTED BY dmm2tgm.py THIS HEADER COMMENT PREVENTS RECONVERSION, DO NOT REMOVE
"a" = (
/turf/template_noop,
/area/template_noop)
"b" = (
/turf/open/lava/smooth{
	initial_gas_mix = "JUNGLE_ATMOS"
	},
/area/ruin/unpowered/demonic_miner_arena)
"d" = (
/obj/machinery/door/airlock/cult/friendly{
	use_power = 0
	},
/turf/open/floor/plating/asteroid/basalt{
	initial_gas_mix = "JUNGLE_ATMOS"
	},
/area/ruin/unpowered/demonic_miner_arena)
"e" = (
/obj/structure/trap/cult,
/turf/open/floor/plating/asteroid/basalt{
	initial_gas_mix = "JUNGLE_ATMOS"
	},
/area/ruin/unpowered/demonic_miner_arena)
"f" = (
/obj/machinery/door/airlock/cult/friendly{
	use_power = 0
	},
/obj/structure/trap/cult,
/turf/open/floor/plating/asteroid/basalt{
	initial_gas_mix = "JUNGLE_ATMOS"
	},
/area/ruin/unpowered/demonic_miner_arena)
"j" = (
/mob/living/simple_animal/hostile/imp/jungle/demonic_miner,
/turf/open/floor/cult{
	initial_gas_mix = "JUNGLE_ATMOS"
	},
/area/ruin/unpowered/demonic_miner_arena)
"l" = (
/turf/open/floor/plating/asteroid/basalt{
	initial_gas_mix = "JUNGLE_ATMOS"
	},
/area/ruin/unpowered/demonic_miner_arena)
"o" = (
/obj/effect/decal/cleanable/blood/old,
/mob/living/simple_animal/hostile/imp/jungle/demonic_miner,
/turf/open/floor/cult{
	initial_gas_mix = "JUNGLE_ATMOS"
	},
/area/ruin/unpowered/demonic_miner_arena)
"p" = (
/obj/structure/stone_tile/cracked{
	dir = 1
	},
/obj/structure/stone_tile{
	dir = 8
	},
/obj/structure/stone_tile{
	dir = 4
	},
/turf/open/floor/cult{
	initial_gas_mix = "JUNGLE_ATMOS"
	},
/area/ruin/unpowered/demonic_miner_arena)
"s" = (
/obj/structure/stone_tile/block/cracked,
/obj/structure/stone_tile/cracked{
	dir = 4
	},
/turf/open/lava/smooth{
	initial_gas_mix = "JUNGLE_ATMOS"
	},
/area/ruin/unpowered/demonic_miner_arena)
"z" = (
/obj/structure/stone_tile/cracked,
/obj/structure/stone_tile{
	dir = 4
	},
/obj/structure/stone_tile{
	dir = 1
	},
/turf/open/floor/cult{
	initial_gas_mix = "JUNGLE_ATMOS"
	},
/area/ruin/unpowered/demonic_miner_arena)
"A" = (
/obj/structure/stone_tile/slab/cracked,
/turf/open/lava/smooth{
	initial_gas_mix = "JUNGLE_ATMOS"
	},
/area/ruin/unpowered/demonic_miner_arena)
"B" = (
/obj/structure/stone_tile/cracked,
/obj/structure/stone_tile/cracked{
	dir = 1
	},
/obj/structure/stone_tile/cracked{
	dir = 8
	},
/turf/open/floor/cult{
	initial_gas_mix = "JUNGLE_ATMOS"
	},
/area/ruin/unpowered/demonic_miner_arena)
"C" = (
/turf/closed/wall/mineral/cult,
/area/ruin/unpowered/demonic_miner_arena)
"H" = (
/obj/structure/stone_tile/surrounding/cracked{
	dir = 6
	},
/mob/living/simple_animal/hostile/megafauna/jungle/demonic_miner,
/turf/open/lava/smooth{
	initial_gas_mix = "JUNGLE_ATMOS"
	},
/area/ruin/unpowered/demonic_miner_arena)
"J" = (
/turf/closed/indestructible/cult,
/area/ruin/unpowered/demonic_miner_arena)
"K" = (
/obj/effect/decal/cleanable/blood/old,
/turf/open/floor/plating/asteroid/basalt{
	initial_gas_mix = "JUNGLE_ATMOS"
	},
/area/ruin/unpowered/demonic_miner_arena)
"L" = (
/obj/structure/stone_tile/slab/cracked{
	dir = 5
	},
/obj/structure/stone_tile/slab/cracked{
	dir = 9
	},
/turf/open/lava/smooth{
	initial_gas_mix = "JUNGLE_ATMOS"
	},
/area/ruin/unpowered/demonic_miner_arena)
"T" = (
/obj/structure/stone_tile/cracked{
	dir = 4
	},
/obj/structure/stone_tile/cracked{
	dir = 8
	},
/obj/structure/stone_tile,
/turf/open/floor/cult{
	initial_gas_mix = "JUNGLE_ATMOS"
	},
/area/ruin/unpowered/demonic_miner_arena)
"W" = (
/obj/structure/stone_tile/slab,
/turf/open/lava/smooth{
	initial_gas_mix = "JUNGLE_ATMOS"
	},
/area/ruin/unpowered/demonic_miner_arena)

(1,1,1) = {"
a
a
a
a
a
a
a
a
a
a
a
a
a
a
a
a
J
f
J
d
J
a
a
a
a
a
a
a
a
a
a
a
a
a
a
a
a
"}
(2,1,1) = {"
a
a
a
a
a
a
a
a
a
a
a
a
a
a
a
a
J
l
e
l
J
a
a
a
a
a
a
a
a
a
a
a
a
a
a
a
a
"}
(3,1,1) = {"
a
a
a
a
a
a
a
a
a
a
a
a
a
a
a
a
J
l
l
l
J
a
a
a
a
a
a
a
a
a
a
a
a
a
a
a
a
"}
(4,1,1) = {"
a
a
a
a
a
a
a
a
a
a
a
a
a
J
J
J
J
d
J
d
J
J
J
J
a
a
a
a
a
a
a
a
a
a
a
a
a
"}
(5,1,1) = {"
a
a
a
a
a
a
a
a
a
a
J
J
J
J
l
l
l
l
l
l
l
l
l
J
J
J
J
a
a
a
a
a
a
a
a
a
a
"}
(6,1,1) = {"
a
a
a
a
a
a
a
a
J
J
J
l
l
l
l
l
l
l
l
l
l
l
l
l
l
l
J
J
J
a
a
a
a
a
a
a
a
"}
(7,1,1) = {"
a
a
a
a
a
a
a
J
J
l
l
l
l
l
l
l
l
b
J
b
l
l
K
l
l
l
l
l
J
J
a
a
a
a
a
a
a
"}
(8,1,1) = {"
a
a
a
a
a
a
J
J
l
l
l
l
l
l
l
l
b
b
J
b
b
l
l
l
l
l
l
l
l
J
J
a
a
a
a
a
a
"}
(9,1,1) = {"
a
a
a
a
a
J
J
l
l
l
l
C
C
l
l
l
J
J
J
J
J
l
l
l
C
C
l
l
l
l
J
J
a
a
a
a
a
"}
(10,1,1) = {"
a
a
a
a
a
J
l
l
l
l
l
K
l
l
l
l
l
l
l
l
l
l
l
l
l
l
l
l
l
l
l
J
a
a
a
a
a
"}
(11,1,1) = {"
a
a
a
a
J
J
l
l
l
l
l
l
l
l
l
K
l
l
l
l
l
l
l
l
l
l
l
l
l
l
l
J
J
a
a
a
a
"}
(12,1,1) = {"
a
a
a
a
J
l
l
l
C
l
l
l
l
l
l
l
l
l
l
l
l
l
l
l
l
l
l
l
C
l
l
l
J
a
a
a
a
"}
(13,1,1) = {"
a
a
a
a
J
l
l
l
C
l
l
l
J
J
b
b
b
l
l
l
b
b
b
J
J
l
l
l
C
l
l
l
J
a
a
a
a
"}
(14,1,1) = {"
a
a
a
J
J
l
l
l
l
l
l
l
J
b
b
b
b
K
l
l
b
b
b
b
J
l
l
l
l
l
l
l
J
J
a
a
a
"}
(15,1,1) = {"
a
a
a
J
l
l
l
l
l
l
l
l
b
b
b
l
K
l
K
l
l
l
b
b
b
l
K
l
l
l
l
l
l
J
a
a
a
"}
(16,1,1) = {"
a
a
a
J
l
l
l
l
l
l
l
l
b
b
l
l
l
l
l
l
l
l
l
b
b
l
l
l
l
l
l
l
l
J
a
a
a
"}
(17,1,1) = {"
J
J
J
J
l
l
l
b
J
l
l
l
b
b
l
l
l
o
J
j
l
l
l
b
b
l
l
l
J
b
l
l
l
J
J
J
J
"}
(18,1,1) = {"
d
e
l
d
l
l
b
b
J
l
l
l
l
K
l
l
j
p
A
T
o
K
l
l
l
l
l
l
J
b
b
l
l
d
l
l
d
"}
(19,1,1) = {"
J
l
l
J
l
l
J
J
J
l
l
l
l
l
l
l
J
s
H
W
J
l
l
K
l
l
l
l
J
J
J
l
l
J
e
l
J
"}
(20,1,1) = {"
d
l
l
f
l
l
b
b
J
l
l
l
l
l
l
l
j
z
L
B
j
l
l
l
l
l
l
l
J
b
b
l
l
d
l
l
d
"}
(21,1,1) = {"
J
J
J
J
l
l
l
b
J
l
l
l
b
b
l
l
l
j
J
o
l
K
l
b
b
l
l
l
J
b
l
l
l
J
J
J
J
"}
(22,1,1) = {"
a
a
a
J
l
l
l
l
l
l
l
l
b
b
l
K
l
l
l
l
l
l
l
b
b
l
l
l
l
l
l
l
l
J
a
a
a
"}
(23,1,1) = {"
a
a
a
J
l
l
l
K
l
l
l
l
b
b
b
l
l
l
K
l
l
l
b
b
b
l
l
l
l
K
l
l
l
J
a
a
a
"}
(24,1,1) = {"
a
a
a
J
J
l
l
l
l
K
l
l
J
b
b
b
b
l
l
l
b
b
b
b
J
l
l
l
l
l
l
l
J
J
a
a
a
"}
(25,1,1) = {"
a
a
a
a
J
l
l
l
C
l
l
l
J
J
b
b
b
l
l
l
b
b
b
J
J
l
l
l
C
l
l
l
J
a
a
a
a
"}
(26,1,1) = {"
a
a
a
a
J
l
l
l
C
l
l
l
l
l
l
l
l
l
l
l
l
l
l
l
K
l
l
l
C
l
l
l
J
a
a
a
a
"}
(27,1,1) = {"
a
a
a
a
J
J
l
l
l
l
l
l
l
l
l
l
l
l
l
l
l
l
l
K
l
l
l
l
l
l
l
J
J
a
a
a
a
"}
(28,1,1) = {"
a
a
a
a
a
J
l
l
l
l
l
l
l
l
l
l
l
l
l
l
l
l
l
l
l
l
l
l
l
l
l
J
a
a
a
a
a
"}
(29,1,1) = {"
a
a
a
a
a
J
J
l
l
l
l
C
C
l
l
l
J
J
J
J
J
l
l
l
C
C
l
l
l
l
J
J
a
a
a
a
a
"}
(30,1,1) = {"
a
a
a
a
a
a
J
J
l
l
l
l
l
l
l
l
b
b
J
b
b
l
l
l
l
l
l
l
l
J
J
a
a
a
a
a
a
"}
(31,1,1) = {"
a
a
a
a
a
a
a
J
J
l
l
l
l
l
l
l
l
b
J
b
l
l
l
l
l
l
l
l
J
J
a
a
a
a
a
a
a
"}
(32,1,1) = {"
a
a
a
a
a
a
a
a
J
J
J
l
l
l
l
l
l
l
l
l
l
l
l
l
l
l
J
J
J
a
a
a
a
a
a
a
a
"}
(33,1,1) = {"
a
a
a
a
a
a
a
a
a
a
J
J
J
J
l
l
l
l
l
l
l
l
l
J
J
J
J
a
a
a
a
a
a
a
a
a
a
"}
(34,1,1) = {"
a
a
a
a
a
a
a
a
a
a
a
a
a
J
J
J
J
d
J
d
J
J
J
J
a
a
a
a
a
a
a
a
a
a
a
a
a
"}
(35,1,1) = {"
a
a
a
a
a
a
a
a
a
a
a
a
a
a
a
a
J
l
l
l
J
a
a
a
a
a
a
a
a
a
a
a
a
a
a
a
a
"}
(36,1,1) = {"
a
a
a
a
a
a
a
a
a
a
a
a
a
a
a
a
J
l
l
l
J
a
a
a
a
a
a
a
a
a
a
a
a
a
a
a
a
"}
(37,1,1) = {"
a
a
a
a
a
a
a
a
a
a
a
a
a
a
a
a
J
f
J
d
J
a
a
a
a
a
a
a
a
a
a
a
a
a
a
a
a
"}
