"a" = (/turf/closed/indestructible/cult,/area/ruin/powered/ancient_ai)
"F" = (/obj/machinery/light{alpha = 0},/obj/machinery/light{alpha = 0},/turf/open/floor/plating/dirt/jungle,/area/ruin/powered/ancient_ai)
"K" = (/turf/open/floor/plating/dirt/jungle,/area/ruin/powered/ancient_ai)
"L" = (/obj/machinery/light{alpha = 0},/turf/open/floor/plating/dirt/jungle,/area/ruin/powered/ancient_ai)
"T" = (/mob/living/simple_animal/hostile/megafauna/wendigo,/turf/open/floor/plating/dirt/jungle,/area/ruin/powered/ancient_ai)

(1,1,1) = {"
aaaaaaaaaaaaaaaaaaaaaaaaaaaaaaaaaaaaaaaaaaaaaaaaaa
aKKKKKKKKKKKKKKKKKKKKLKKKKKKKKKKKKKKKKKKKKKKKKKKKa
aKKKKKKLKKKKKKKKKKKKKKKKKKKKKKKKKKKKKKLLKKKKKKKKKa
aKKKKKKLKKKKKKKKKKKKKKKKKKKKKKKKKKKKLKKKKKLKKKKKKa
aKKKLKKKKKKKKKKKKKKKKKKKKKKKKKKLKKKLKKKKKKKKKKKKKa
aKKKKKKKKKLKKKKKKKKLLLLKLKKKKKKKKKKKKKKKKKKKLLKKKa
aKKKLKKKKKKKKKLKKKKKKKKKKKKKKKKKKKKKKKKKKKKKKKKKKa
aKKKKKKLKKKKKKKKKKKKKKKKKKKKLKKKKKKKKKKKLKKKKKLKKa
aKKKKKKKLKKKLLKKKKKKKKKKKKKLLKKKLKKLKKLKKKKKKLLKKa
aKKKKKKKKFKKKKKKKKKKKKKKKKKLKKKKKKKLKKLKKKLKKKKKKa
aKKKKKKKKKKKKKKKKKKKKLLKKKKKKKKKLKKKKKLKKKLLLKKKKa
aKKKKKKKLKKKKKKKKKLKKKKKKKKKKKKLKKKKKKKKKKKKKKKKKa
aKKKKKKKKKKKKKLKKKKKKKKKKKKKKKKLKKKKKKKKKKKKKKKKKa
aKLKKKKKKKKKKKLLKKKKKKKKLKKKKKKKKKKKKKKKKKKKKKKKKa
aKKKKKKKKKKLLKKKKKKKKKKKKKKKKKKLKKKLKKKLKKKKKKKKKa
aKKKKKKKKKKLKKKKKKKKLLKKKKKKKKLKKKKLKKKLLKKKKKKKKa
aKKKKKLLKKKKKKKKKKKKKLLKKKKKKLKKKKKKKKKKKKLKKKKKKa
aKKKKLLLKKKLKKKKKLLKKKKKKKKKLLKKKKLLKKKKKKKLKKKKKa
aKKKKKKKKKKKLKKKKKKKKKKKKKLKKKKKKKKLLLKKKKKKKKKKKa
aKKKKLKKKKKKKLKKKKKKKKLKKKKKKKKKKKKKKKKKKKKKKKLKKa
aKKKLKKKKKKKKKLKKKKKKKKKKKKKKKKLKKKKKKKLKKKKKKKKKa
aKKKLKKKKKKKKKLKKLKKKLKKKKKKKKKLKKKKLKKLKKKKKKKKKa
aKKKKKKKKKKKKKKKKKKKFLKKKKKKKKKKLLKKKLKKKKKKKKKKKa
aKKKKKKLKKKKKKKKKKKKLKKKTKKKKKKKLKKKKKKKKKKKKKKKKa
aKKKKKKKKKKKKKKKKKKKKKKKKLLFKKKKKKKKKKKKKKKKLKKKKa
aKKKKKKKKKKKKKKLKKKKKKLLKKKLLKKKKKKKKKKKKKKKLLKKKa
aKKKKKLKKKKKKKKKKKKKKLLKKKKLKKKKLLKKKKKKKKKKKKKKKa
aKLKKKKKKLKKKKKLKKKKLLKKKKKLKKKKKKKKKKKKKKKKKKKKKa
aKKKKKKKKKKKKKKKKKKKKKKKKKKKLLLLKKKLKKKKKKKKKKKKKa
aKKKKKKKKKKKKKLKKKLKKKKKKKKKKKKKKLKLKKKKKKKKLKKKKa
aKKKKKKKKKKKKLKKKKLLKKKKKKKLKKKKKKKKKLLKKKKKKKLKKa
aKKLKKKLKKKKKKKKKKKKKKKKKKKKKKKKKKKKLKKKKKKKKKKKKa
aKKKKKKLKKKKKLKKKKKKKLKKKLKKKKKKKKKKKKKKKKKKKKLKKa
aKKKKKKKKKKKLKKKKKKKKKKKKKKKKKKKKKKKKKKKKLKKKKLKKa
aKKKKKKKKKKKKKKKKKKKKKKKKKKKKKKLKKKKKKKKKKKKKKKKKa
aKKKKKKKLKKKKKKKKKKKKKLLKKKKKKKKKKKLKKKKKKKLKKKKKa
aKKKKKKKKKKKKLLKKKKKKKKKKKKKKKLKKKKLKKKKKKKKKKKKKa
aKKKKKKKKKKKKKLKKKLKKKKKKKKKKLKKKKKLKKKKKKLLKKKKKa
aKKKKKLKKKKKKKLKKKKKKKKKKKLLLKKKKKKLKKKKLLLKLLKKKa
aKKKKKLKKKKKKKKKKKKKKKKKKKKKKKKKKKKKKKKLKKKKKKLKKa
aKKKKKKKKKKKKKKKKKKKKKLLKKKKKKKKKKKKKKKKKKKKKKLKKa
aKKKKKKKKKKKKKKLKKLKKKLKKKKKKKKKKKKLKKKKKKKKKKLKKa
aKKKKKKKLFLKKKKKKKKKKKKKKKKKKLKKKKKKKKKKKKKKKLKKKa
aKKLKLLKKKLLKKKKKKKKKKKKKKKKKKKKKLLKKLKKKKKKLKKKKa
aKKLKKLKKKKKKKKKKKKLLLKKKKKKKKKKKKKKKKKLKKKLLKKKKa
aKKLKKKKKKKKKKKKKKKKKKLLKKKKKKKKKKKKKKKKLLKLKKKKKa
aKKKLLKKKKKKKKKKLKKKKKKKLLKKLKKKKKKKKKKKKLKKKKKKKa
aKKKKKKKKKKKKKKKLLKKKKKKKKKKKLKKKKKKKKKKKKKKKKKKKa
aKKKKKKKKKKKKKKKKKKKKKKKKKKKKKKKKKKKKKKKKKKKKKKKKa
aaaaaaaaaaaaaaaaaaaaaaaaaaaaaaaaaaaaaaaaaaaaaaaaaa
"}
